1111111111111
10000000000C1
1001011011001
1P0111000E001
1111111111111