1111111111111111111111111111111111
10000C0000000000000000000000000001
111111010010E000101001101110010101
1010010010101010001001000010010101
10000000000000000000010P0010000001
1111111111111111111111111111111111