1111111111111
1C000000000C1
1100011011011
1PC11101CE001
1111111111111