1111111111111
1C000000000C1
1100011010111
1PC11101000E1
1111111111111