1111111111111111111111111111111111
1000000000000000C00000000000C00001
111111010010E000101C01000000010101
1010010010101010001001000000010101
1000000000000000000C000P0000000001
1111111111111111111111111111111111